






1111111111111111111111111111
1000000000000001010000111101
110111111111000001C000000001                 
10PC0000000C0000M10000000001 
10C011C0E0010000011100000001
11000000000000000000M0000001         
110000C0CC000000000000000001
1111C1C1C000CC1C000000000011
1111111000000000101010101011
1110000000010000000000000001
10CC01110000CC00000000000011
1111111111111111111111111111







