111111111
101000001
100100101
1P0E00C11                  
111111111
100000001
111111111









